################################
#                              #
#                              #
#                              #
#    #################         #
#                    #         #
#                    #         #
#                              #
#                    #         #
# ##############################
# ##############################
# ##############################
# ##############################
# ##############################
# ##############################
# ##############################
# ##############################
# ##############################
# ##############################
# ##############################
# ##############################
#                     #        #
#                     #        #
#      ################        #
#      #                       #
#      #                       #
#      #                       #
#      ################        #
#                              #
#                              #
################################
################################


