################################
#                            # #
# ######### ###### ##### ##### #
# #       #      #     # #     #
# # ##### ###### ##### # ##### #
# ###   #            # #     # #
#     ############## # ####### #
#### ##            # # #     # #
#       ## ####### # # # ### # #
# #######  #       # # # #     #
# #  #    ## ####### #   ##### #
# #     #### #       # # #   # #
# #  #       # #  #    #   # # #
###  ####### ################# #
#          #                 # #
# ##### #### ### #### ###### # #
# #     #  # #        #    # # #
# #  #     #        # # #### # #
# # ######## ####a### #      # #
#                     ###### # #
##################### ##   # # #
#    #   #   #        #  #   # #
# ##   #   #    # ############ #
#################     #   #  # #
#               ##### # # # ## #
# ########### # #     # # #  # #
# #         # ### ### # #### # #
# # ######### #   #          # #
# #           # # #  ######### #
# ############# # #  #   #   # #
#               # #    #   # # #
################################
