####-###########################
#                            # +
# ######### ###### ##### ##### #
# #       #      #     # #     #
# # ##### ###### ##### # ##### #
# ###   #            # #     # #
#     ############## # ####### #
#### ##                      # #
#               ##           # #
#                              #
#                            # #
#                            # #
#                            # #
#          # ################# #
#          #                 - #
#          # ### #### ###### # #
#          # #        #    # # #
#          #        # # #### # #
#          # #### ### #      # #
#                     ###### # #
##################### ##   # # #
#    #   #   #        #  #   # #
# ##   #   #    # ############ #
#################     #   #  # #
#               ##### # # # ## #
# ########### # #     # # #  # #
# #         # ### ### # #### # #
# # ######### #   #          # #
# #           # # #  ######### #
# ############# # #  #   #   # #
#               # #    #   # # #
###-############################
