################################
#                              #
#                              #
#                              #
#    #################         #
#                    #         #
#                    #         #
#                              #
#                    #         #
#                    #         #
#                    #         #
#     ################         #
#     #                        #
#     #                        #
#     #        #      ##  ###  #
#     #       ###     #     #  #
#              ##     #     #  #
#     #               ##  ###  #
#     #                        #
#     #################        #
#                     #        #
#                     #        #
#                              #
#                     #        #
#      ################        #
#      #                       #
#      #                       #
#      #                       #
#      ################        #
#                              #
#                              #
################################
