################################
#                              #
#            ######            #
#            #     #########   #
#            #      #          #
#       ###########            #
#       #    #                 #
#       # ####                 #
#                              #
#   #########################  #
#   #                          #
#   #  ################  #     #
#   #                 #  #     #
#   #  #              #  #     #
#   #  #              #  #     #
#   #  #              #  #     #
#   #  #              #  #     #
#   #  #              #  #     #
#   #  #                 #     #
#   #  ################  #     #
#                        #     #
#  #######################     #
#         #                    #
#                          #   #
#     ######################   #
#     #                        #
#     #               #        #
#                     #        #
#  ####################        #
#                              #
#                              #
################################