################################
#                              #
# ############ ############### #
# #            #             # #
# #            #             # #
# #            #             # #
# #            #             # #
# #            #             # #
# #            #             # #
# #            #             # #
# #            #             # #
# #    #       #             # #
# #    #       #             # #
# #    # ############ #      # #
# #    # #            #      # #
# #    # # # ### #### #        #
# #    #   # #        ######## #
# ##########        # #   #  # #
#      #   # #### ### # # #  # #
# ## # # # #            # #  # #
# #  # # # # ############ #  # #
# # ## # # #    #         #  # #
# #  # # # #### # #########  # #
# ## # # #      #            # #
# #  # # ################### # #
# # ## #        #  #   #   # # #
# #  # # ###### #  # # # # # # #
# ## # # #    # #  # # # # # # #
# #  #   # ##   #    #   #   # #
# ############### ############ #
#                              #
################################
