################################
#                              #
# ############ ############### #
# #   #   #    #  #   #      # #
# # # # # # ## ##   #   # #  # #
# # # # # # #  ########## #  # #
# # # # # # # ##          #  # #
# # # # # # #  # ##########  # #
# # #   #   ## #          #  # #
# # ##################### #  # #
# #            #        # #  # #
# #### ####### # ###### # #  # #
# #    #       #      # # #  # #
# # #### ############ # # #  # #
# #    # #            # # #  # #
# #### # # # ### #### #   #    #
# #    #   # #        ######## #
# ##########        # #   #  # #
#      #   # #### ### # # # ## #
# ## # # # #            # #  # #
# #  # # # # ############ ## # #
# # ## # # #    #         #  # #
# #  # # # #### # ######### ## #
# ## # # #      #            # #
# #  # # ################### # #
# # ## #        #  #   #   # # #
# #  # # ###### #  # # # # # # #
# ## # # #    # #  # # # # # # #
# #  #   # ##   #    #   #   # #
# ############### ############ #
#                              #
################################
