################################
#                              #
#   #########################  #
#                           #  #
#                           #  #
#                           #  #
# ###########################  #
# #                            #
# #                            #
# # #########################  #
# # #                       #  #
# # #  ################  #  #  #
# # #                 #  #  #  #
# # #  #              #  #  #  #
# # #  #              #  #  #  #
# # #  #              #  #  #  #
# # #  #              #  #  #  #
# # #  #              #  #  #  #
# # #  #                 #  #  #
# # #  ################  #  #  #
# #                      #  #  #
# ########################  #  #
#                           #  #
#                           #  #
#  ##########################  #
#  #                           #
#  #                        #  #
#  #                        #  #
#  #                        #  #
#  ##########################  #
#                              #
################################