################################
#                              #
#                              #
#                              #
#    #################         #
#                    #         #
#                    #         #
#                    #         #
#                    #         #
#                    #         #
#                    #         #
#            #########         #
#                              #
#                              #
#                              #
#                              #
#                              #
#                              #
#                              #
#                              #
#                              #
#                              #
#                              #
#                              #
#                              #
#                              #
#                              #
#                              #
#                              #
#                              #
#                              #
################################